1111111111111111111111111111111111111111111111111111111
1111111111111111111111111111111111111111111111111111111
11                                                   11
11                                                   11
11                        III                        11
11                                                   11
11   111                                       111   11
11    111                                     111    11
11     111                                   111     11
11      111                                 111      11
11       111                               111       11
11        111                             111        11
11         111                           111         11
11          111                         111          11
11           111                       111           11
11            111                     111            11
11             111                   111             11
11              111                 111              11
11               111               111               11
11                111             111                11
11                 111           111                 11
11                  111         111                  11
11                   111       111                   11
11                    111     111                    11
11                     111   111                     11
11                                                   11
11   I                                          I    11
11   I                     P                    I    11
11   I                                          I    11
11                                                   11
11                     111   111                     11
11                    111     111                    11
11                   111       111                   11
11                  111         111                  11
11                 111           111                 11
11                111             111                11
11               111               111               11
11              111                 111              11
11             111                   111             11
11            111                     111            11
11           111                       111           11
11          111                         111          11
11         111                           111         11
11        111                             111        11
11       111                               111       11
11      111                                 111      11
11     111                                   111     11
11    111                                     111    11
11   111                                       111   11
11                                                   11
11                                                   11
11                        III                        11
11                                                   11
1111111111111111111111111111111111111111111111111111111
1111111111111111111111111111111111111111111111111111111