hhhhhhhhhhhhhhhhhhhhhhhhhhhhhhhhhhhhhhhhhhhhhhhhhhhhhh
hhhhhhhhhhhhhhhhhhhhhhhhhhhhhhhhhhhhhhhhhhhhhhhhhhhhhh
hh        hh                  hh                    hh
hh    P   hh        OO        hh        OO          hh
hh        hh   OO   hh   OO   hh   OO   hh    OO    hh
hh        hh        hh        hh        hh          hh
hh        hh        hh        hh        hh          hh
hh        hh        hh        hh    gggghh          hh
hh        hh        hh        hh        hh          hh
hh  T     hh        hh        hh     C  hh          hh
hh        hh        hh        hh        hhggggg     hh
hh        hh        hh        hh        hh          hh
hh        hh        hh gggg   hh        hh          hh
hh        hh    ggg hh        hh        hh          hh
hh    T   hh        hh        hh   CCC  hh          hh
hh        hh        hh        hh        hh     ggg  hh
hh        hh  C     hh    ggg hh        hh          hh
hh        hh        hh        hh        hh          hh
hh        hh        hh        hh        hh          hh
hh        hh   OO   hh   OO   hh   OO   hh    OO    hh
hh  T     hh        hh        hh        hh          hh
hh        hh        hh        hh        hh gg       hh
hh        hh        hh   H    hh        hh          hh
hh        hh        hh        hh        hh          hh
hhgggg    hh  CCC   hh  ggg   hh        hh          hh
hh        hh        hh        hh  gg    hh  gggggg  hh
hh        hh        hh        hh        hh          hh
hh        hh  ggg   hh        hh     g  hh          hh
hh        hh        hh        hh        hh      H   hh
hh    gggghh        hh        hh    gg  hhggg       hh
hh        hh        hh    ggg hh        hh          hh
hh        hh        hh        hh        hh          hh
hh        hh        hh        hh        hh          hh
hh        hh        hh        hh        hh          hh
hh   OO   hh   OO   hh   OO   hh   OO   hh    OO    hh
hh        hh        hh        hh        hh          hh
hh        hh        hh        hh        hh          hh
hh CCCC   hh      g hh        hh        hh          hh
hh        hh     g  hh        hh        hhggggg     hh
hh        hh        hh        hh   g    hh          hh
hh        hh        hh        hh        hh          hh
hh        hh  ggg   hh  ggg   hh        hh          hh
hh        hh        hh        hh        hh          hh
hh   gggg hh        hh        hh        hh   gggggg hh
hh        hh        hh        hh        hh          hh
hh        hh        hh        hh        hh          hh
hh        hh        hh        hh        hh          hh
hh        hh        hh        hh        hh          hh
hh        hh        hh        hh        hh          hh
hh   OO   hh   OO   hh   OO   hh   OO   hh    Z     hh
hh                  hh                  hh          hh
hh        OO        hh        OO        hh          hh
hhhhhhhhhhhhhhhhhhhhhhhhhhhhhhhhhhhhhhhhhhhhhhhhhhhhhh
hhhhhhhhhhhhhhhhhhhhhhhhhhhhhhhhhhhhhhhhhhhhhhhhhhhhhh